Goldweber Michael
Liebert Mindy
Goldweber Eli
Rautenstrauch	Francoise
Loud	Kendra
Bauswell	Lourdes
Edmison	Hannah
Loeza	Tom
Kramarczyk	Queenie
Portaro	Hui
Opitz	Josefa
Steinhaus	Lea
Vielma	Paola
Bresser	Hortencia
Tijerina	Leanna
Pride	Danilo
Marcille	Huey
Warne	Apolonia
Lagos	Chandra
Pacholec	Crissy
Branin	Gianna
Billa	Valentin
Dudash	Ilona
Lablanc	Willard
Randol	Lauryn
Begin	Laurena
Michelle	Elise
Kardell	Corrie
Rabuse	Kimberely
Violett	Tish
Stanfield	Hollis
Christmann	Andree
Fucillo	Lyla
Yafuso	Felton
Polino	Dell
Leko	Nohemi
Lembke	Tambra
Maikoksoong	Vicki
Airhart	Renato
Darbro	Lenita
Hagen	Barney
Armacost	Matthew
Nelton	Belen
Wardle	Iesha
Sarchet	Francesco
Rhule	Paulene
Hughlett	Carole
Dunning	Miss
Hinsch	Elfrieda
Calzado	Edelmira
Wasurick	Jaime
Hua	Lera
Mastro	Jame
Hailstone	Jillian
Zarling	Louis
Mcshaw	Emmett
Sams	Tammy
Wylie	Willis
Brzozowski	Maxima
Latif	Boris
Knavel	Salina
Dini	Justa
Wolfgang	Amalia
Tutterrow	Felix
Mcglocklin	Eura
Heuring	Lang
Lakatos	Agustin
Lowrance	Jaime
Gudiel	Carman
Hofbauer	Argelia
Cisney	Mammie
Menino	Rashad
Bastain	Janna
Neikirk	Callie
Helmcamp	Coral
Mushero	Xenia
Nitcher	Adelle
Wehrwein	Hildegarde
Sugai	Phuong
Lafoy	Leontine
Mcalarney	Darell
Landman	Madonna
Berggren	Chuck
Epperheimer	Gregg
Bubrig	Yan
Garlett	Stephanie
Stenquist	Alberto
Shivers	Wayne
Bothe	Kristal
Stadel	Florencia
Tumolillo	Darrin
Rudig	Freeman
Mollison	Lazaro
Rieg	Ellsworth
Mrkvicka	Brinda
Mackedanz	Florinda
Swartzbeck	Nadine
Torchio	Arlette
Krivanec	Adolph
Colbath	Georgiana
Lehn	Rana
Morgan	Chi
Prothro	Starr
Roseum	Glennis
Petermeier	Thea
Persechino	Rosalind
Tapian	Shenika
Vandeberg	Veta
Geneseo	Herschel
Tomasic	Dianne
Gerten	Micah
Alaibilla	Kaycee
Brang	Tesha
Chhour	Marya
Kettelle	Ronnie
Fower	Mabel
Works	Harley
Nedman	Joye
Harnish	Luisa
Lortz	Stacey
Mesmer	Reyes
Demus	Avery
Scotts	Colby
Wrinkle	Afton
Sifford	India
Coin	Brunilda
Emanuel	Jenifer
Nosis	Makeda
Oppy	Vivan
Gazzola	Eric
Davirro	Thersa
Presnal	Mindy
Metzner	Luis
Mcloud	Dawne
Kinikini	Karrie
Hermon	Mozelle
Hair	Mila
Jefferys	Gilma
Mcduffie	Armanda
Normandeau	Vonda
Mondale	Truman
Tenuta	Elvis
Dedaj	Loise
Pedder	Jannette
Rand	Margo
Benett	Dahlia
Mckeon	Dominga
Keomuangtai	Hollis
Ziller	Carry
Fears	Bong
Staiano	Yolande
Hegdahl	Lottie
Kylish	Jose
Abramovitz	Tuyet
Provenzano	Pearline
Hankison	Robt
Kesten	Shawnee
Quinones	Lacresha
Vinroe	Basilia
Areizaga	Aleisha
Tryninewski	Frank
Steinhorst	Ria
Kallenberger	Carla
Skahan	Lashanda
Catalina	Jarod
Rabago	Leoma
Greeves	Yasuko
Snelling	Jimmie
Dugre	Titus
Teoh	Joanne
Groom	Suzi
Amazan	Denny
Coughlan	Willie
Brake	Margurite
Romack	Arlen
Corna	Shaniqua
Boccard	William
Riviere	Silva
Haberle	Gearldine
Aja	Azalee
Plikerd	Kimbery
Kratt	Ricarda
Massay	Macy
Normington	Carol
Czaplinski	Blythe
Tesseneer	Tanesha
Orndoff	Yaeko
Lorenz	Broderick
Shadle	Twila
Pead	Sarina
Peets	Candra
Aprigliano	Von
Verso	Natalya
Rigazio	Stanton
Larner	Dona
Choice	Cortney
Betterton	Ira
Pickle	Vanna
Sabota	Bo
Corners	Nathalie
Lockamy	Rodney
Hairr	Elena
Kraatz	Blossom
Griepentrog	Loreen
Keirnan	Tayna
Planty	Nieves
Robinault	Glenn
Racer	Julianna
Nitchals	Ashton
Scovil	Shaun
Shintaku	Long
Meir	Vinnie
Flipp	Lucia
Ivaska	Corazon
Perugini	Jaime
Stakes	Miriam
Nigl	Vallie
Isachsen	Sheldon
Balonek	Nickie
Caneles	Fletcher
Eisert	Rutha
Geigel	Brandon
Lamme	Franchesca
Naddeo	Lorriane
Berson	Asuncion
Hoerter	Georgiann
Bultron	Hershel
Collopy	Chu
Vosmus	Bettina
Sport	Lynsey
Kuechler	Phil
Nicks	Cordelia
Marrano	Georgeanna
Lanter	Rosendo
Norcia	Jerilyn
Bakeley	Elfriede
Sheck	Harris
Beilinson	Leonor
Waska	Terrilyn
Foulds	Maddie
Anstead	Melynda
Thigpen	Odette
Meinen	Steffanie
Stimac	Antonette
Daneker	Thora
Massanet	Nada
Dills	Ivette
Delacerda	Devon
Tibbles	Lon
Santanna	Tennie
Vilven	Fidelia
Gunyan	Michal
Yandow	Enola
Mamudoski	Meghann
Mattia	Latanya
Firlik	Chandra
Dewer	Barney
Chreene	Ocie
Dubray	Precious
Laramie	Sanda
Benavente	Gaynell
Cutsforth	Bethanie
Capiga	Yvette
Blackmon	Alana
Beachel	Lakeesha
Friedman	Ailene
Madson	Valene
Bub	Floyd
Hatherly	Josue
Wadden	Johnathon
Drizin	Kenneth
Titzer	Leila
Quinlisk	Marquetta
Beliles	Annamae
Dosal	An
Cortesi	Karina
Luong	Otis
Kasperek	Brendan
Evartt	Keith
Arand	Paulina
Welschmeyer	Cherelle
Neelon	Percy
Storrs	Margot
Bellis	Paris
Masiejczyk	Sina
Selfe	Kimi
Richrdson	Chun
Thiemann	Lelia
Zinda	Cordell
Aitken	Dorothy
Mcelreath	Chauncey
Stropko	Tenesha
Lovero	Anjelica
Adessa	Olga
Tindal	Monte
Mccoskey	Pamela
Lippoldt	Toshia
Sandusky	Polly
Boerboom	Judy
Pritt	Celestine
Fode	Murray
Courter	Shoshana
Pezley	Glendora
Kana	Carlene
Gilliam	Adria
Perkins	Paola
Maury	Elina
Dorio	Emile
Lannigan	Zoila
Yestramski	Yong
Stalma	Leontine
Dicus	Troy
Vanhuss	Annamaria
Lowther	Dorothea
Letran	Marion
Masso	Avery
Bredernitz	Trinidad
Penso	Herminia
Bigaud	Val
Oviedo	Renay
Kotow	Buck
Rollison	Toi
Liebert Sadie
Pennel	Shanice
Ramerez	Oliva
Crocker	Tamera
Rather	Melvin
Fitzke	Essie
Knieper	Shay
Sensibaugh	Ruby
Doscher	Caren
Amend	Frank
Frisinger	Lasandra
Frere	Sommer
Mckeon	Gretchen
Marien	Providencia
Arnoldi	Lindsey
Riesgraf	Romana
Logwood	Nobuko
Arredondo	Shawnna
Hathcox	Doyle
Deppen	Jacinta
Kuamoo	Tawanna
Cloutier	Christa
Kotz	Noe
Fajen	Ellen
Pelletier	Tequila
Bonventre	Tawny
Mcspedon	Rosalyn
Miyata	Noble
Hubbell	Lucille
Tuazon	Azzie
Arau	Darci
Suman	King
Zeanah	Denny
Frayer	Anissa
Heinricher	Rosann
Rippy	Jeannine
Casteneda	Lashaun
Walen	Miesha
Kountz	Marva
Lamastus	Dion
Sarkin	Hassie
Perry	Jin
Peth	Demetra
Benauides	Irene
Pesqueira	Colton
Cilento	William
Cupit	Shannan
Kast	Shelba
Diebold	Dorcas
Wetherby	Rochell
Windell	Amber
Prinkey	Stefanie
Sharples	Kenia
Libbey	Jacquline
Michelet	Lavina
Kazar	Billi
Leuthold	Aron
Tartar	Annice
Zarazua	Hyun
Ogle	Shala
Canonico	Shasta
Braseth	Wenona
Gallati	Marla
Palenik	Myra
Jacocks	Lawanda
Kohlman	Curt
Finstad	Susy
Kaper	Kathrine
Pospishil	Oneida
Perera	Allene
Leahman	Leonardo
Russi	Nakisha
Rolling	Stephanie
Haycock	Florinda
Geberth	Merri
Vereen	Malcom
Abney	Louvenia
Borlace	Alita
Ill	Noemi
Ancar	Nydia
Meisel	Hana
Marrazzo	Noel
Rowe	Brice
Kitchens	Nguyet
Mair	Janae
Makley	Darrel
Milionis	Genevieve
Bacho	Giovanna
Spannuth	Shelton
Mahlum	Alison
Zufall	Maynard
Bussert	Timothy
Eddens	Viola
Michon	Luann
Goerke	Mable
Kaea	Sabine
Moltz	Dolores
Suero	Hannah
Blan	Sonia
Stapels	Cletus
Zoldak	Asha
Billow	Verlene
Giglio	Yesenia
Sine	Tayna
Jobst	Verona
Eggers	Denae
Montalgo	Rikki
Weekly	Nan
Despain	Sherell
Brennick	Coral
Huelse	Phyliss
Wida	Jesse
Helander	Latonia
Clozza	Aimee
Staie	Marcelle
Schuring	Ilda
Klukken	Aileen
Zeng	Davida
Rubarts	Beata
Wieand	Angelyn
Hummell	Claudio
Twyman	Krystal
Echegoyen	Adela
Phibbs	Ryan
Buettner	Edmond
Emmert	Catina
Pattengale	Milly
Erichsen	Jules
Miklitz	Denna
Cesa	Willetta
Magathan	Johna
Oliverson	Ollie
Vitrano	Sherly
Dishong	Kindra
Tentler	Vanda
Fitgerald	Marshall
Hasha	Kelvin
Mathiasen	Darrin
Mccarley	Susana
Nickelson	Wilson
Talty	Malissa
Castillanos	Tandra
Sammon	Lorean
Oien	Desirae
Cerao	Delsie
Elmquist	Mabel
Purslow	Marnie
Granier	Rene
Harnist	Trevor
Batdorf	Sharmaine
Traux	Ricki
Shufelt	Bernadine
Reider	Shad
Degennaro	Kenneth
Hennon	Marleen
Geitner	Joaquin
Stockham	Slyvia
Bala	Kris
Diflorio	Gussie
Lillywhite	Lavelle
Dermo	Bev
Digiovanni	Bette
Mccloud	Lajuana
Westervelt	Shakira
Nickolich	Matt
Momplaisir	Clemencia
Ambert	Oliva
Maye	Ranee
Eskew	Ming
Peckens	Annice
Frymark	Effie
Conger	Maricela
Plantenberg	Esteban
Wykle	Doretha
Neitzke	Dorsey
Okuniewski	Amie
Berkoff	Bulah
Delbosque	Erin
Marushia	Kassandra
Matsuno	Leslee
Dobler	Daniel
Unruh	Antonio
